23 13
13 11
01 02 02 02 02 02 02 04 08 04 02 02 02 02 02 02 02 02 02 02 02 02 03
05 05 05 05 05 05 05 04 08 04 05 05 05 05 05 05 05 05 05 05 05 05 06
05 05 05 05 05 04 05 04 08 04 05 05 05 05 05 05 05 05 05 05 05 05 06
05 05 05 05 05 05 05 04 08 04 05 04 05 05 05 05 05 05 05 04 05 05 06
05 05 05 05 05 05 05 04 04 04 05 05 05 05 05 05 05 05 05 05 05 05 06
05 05 05 05 05 05 05 05 05 05 05 05 05 05 05 05 05 05 05 05 05 05 06
05 05 05 05 05 05 05 05 05 05 05 05 05 05 05 05 05 05 05 05 05 05 06
05 05 05 05 04 05 05 05 05 05 05 05 05 05 05 05 05 05 05 05 05 05 06
05 05 05 05 05 05 05 04 04 04 05 05 05 05 05 05 04 05 05 05 05 05 06
05 05 05 05 05 05 05 04 08 04 05 05 05 05 05 05 05 05 05 05 07 07 06
05 05 04 05 05 05 05 04 08 04 05 05 05 05 05 05 05 05 05 05 05 07 06
05 07 05 05 05 05 05 04 08 04 05 05 05 05 05 05 05 05 05 04 05 05 06
05 05 05 05 05 05 05 04 08 04 04 05 05 05 05 05 05 09 09 09 09 09 06