23 13
13 11
11 12 12 12 12 12 12 14 18 14 12 12 12 12 12 12 12 12 12 12 12 12 13
15 15 15 15 15 15 15 14 18 14 15 15 15 15 15 15 15 15 15 15 15 15 16
15 15 15 15 15 15 15 14 18 14 15 15 15 15 15 15 15 15 15 15 15 15 16
17 15 15 15 15 15 15 14 18 14 15 15 15 15 15 15 15 15 15 15 15 15 16
17 15 15 15 15 15 15 14 18 14 15 15 15 19 19 19 15 17 17 15 15 15 16
17 15 15 15 15 15 15 14 14 14 15 15 15 19 18 19 11 13 17 15 15 15 16
17 15 15 15 15 15 15 15 15 15 15 15 15 19 19 19 15 16 17 15 15 15 16
17 15 15 15 15 15 15 15 15 15 15 15 15 19 19 15 15 16 17 15 15 15 16
17 15 15 15 15 15 15 14 14 14 15 15 19 19 15 15 15 11 12 15 15 15 16
17 15 15 15 15 15 15 14 18 14 15 15 19 19 15 15 15 15 15 15 15 15 16
17 15 15 15 15 15 15 14 18 14 15 15 15 15 15 15 15 15 15 15 15 15 16
17 15 15 15 15 15 15 14 18 14 15 15 15 15 15 15 15 15 15 15 15 15 16
17 15 15 15 15 15 15 14 18 14 15 15 15 15 15 15 15 15 15 15 15 15 16