23 13
0 6
31 32 32 32 32 32 32 32 32 32 32 32 32 32 32 32 32 32 32 32 32 32 33
38 35 35 35 35 35 35 34 35 35 35 35 35 35 35 35 35 35 35 35 35 35 36
34 38 35 35 35 35 35 35 35 38 35 35 35 35 35 35 35 35 35 35 38 35 36
37 38 35 35 38 35 35 35 35 35 35 35 35 35 35 35 35 35 35 35 35 35 36
39 34 35 35 35 39 35 35 35 35 35 35 35 35 35 38 34 38 35 35 35 35 36
38 38 35 35 35 35 35 35 35 35 35 39 35 35 35 34 39 34 35 35 35 35 36
38 38 35 35 35 35 38 35 35 35 35 35 35 35 35 38 34 38 35 35 35 35 36
38 38 35 35 35 35 35 35 35 35 35 35 35 35 35 35 35 35 35 35 35 35 36
39 38 35 35 35 35 35 35 35 35 35 35 35 35 35 35 35 35 35 35 35 35 36
37 39 35 35 35 37 34 38 34 38 35 35 35 35 35 35 35 35 35 34 35 35 36
35 35 35 35 35 35 35 35 38 35 35 35 35 35 35 35 38 35 35 35 35 35 36
35 35 35 35 35 35 35 38 34 37 35 35 35 35 35 35 35 35 35 35 35 35 36
35 35 35 35 35 35 35 35 38 35 35 35 35 35 35 35 35 35 35 35 35 35 36