23 13
0 6
3 3 3 3 3 3 3 3 1 1 1 1 1 0 0 0 0 0 0 0 0 0 0
2 3 3 3 3 3 3 3 1 1 0 1 1 0 2 2 2 0 0 0 0 11 0
2 2 3 3 3 3 3 3 1 0 0 1 1 0 2 13 2 0 0 0 0 0 0
0 2 2 2 3 3 3 3 1 0 0 1 1 0 2 2 2 0 0 0 0 0 0
0 2 2 2 2 3 3 3 1 0 0 1 1 0 0 0 0 0 0 0 0 0 0
0 0 2 2 2 3 3 3 1 2 0 1 1 0 0 0 0 0 0 0 11 0 0
0 0 0 2 2 2 2 2 2 2 0 1 0 0 11 0 0 4 0 0 0 0 0
0 0 2 2 2 3 3 3 1 2 0 0 0 0 0 0 0 4 4 0 0 2 2
0 2 13 2 2 3 3 3 1 0 0 11 0 0 0 0 4 14 4 0 0 2 2
0 2 2 2 3 3 3 3 1 0 0 0 0 0 0 0 0 4 4 0 0 0 0
2 2 3 3 3 3 3 3 1 0 0 0 0 2 2 0 0 0 4 0 0 0 0
2 3 3 3 3 3 3 3 1 0 0 0 0 2 2 0 0 0 0 0 11 0 0
3 3 3 3 3 3 3 3 1 0 0 0 0 2 2 0 0 0 0 0 0 0 0 